10 10
1111111111
1111111111
1111113333
1111111111
1111111111
1113333111
1111111111
1333311111
1111111111
1111211111
