10 20
33333333333333333133
11331111111111131111
33311133333111131111
11331111113111111311
11111111333111111131
11133331113111111131
11111133333111111131
33333111113111111311
11331133313111113111
12111111113111111111
